zxxxxxxxxxxxxxz
zx00000000000xz
zx00000000000xz
zx00000000000xz
zx00000000000xz
xx00000000000xz
ss00000000000gg
ps00000000000gg
ss00000000000gg
xx00000000000xz
zx00000000000xz
zx00000000000xz
zx00000000000xz
zx00000000000xz
zxxxxxxxxxxxxxz
