xxxxxxxxxxxxxxx
xx00000000000xx
xx00000000000xx
xx00000000000xx
xx00000000000xx
xx00000000000xx
ss00000000000gg
ps00000000000gg
ss00000000000gg
xx00000000000xx
xx00000000000xx
xx00000000000xx
xx00000000000xx
xx00000000000xx
xxxxxxxxxxxxxxx
