xxxxxxxxxxxxxxx
x0000000000000x
x0000000000000x
x0000b000b0000x
x0000b000b0000x
x0000b000b0000x
xs000000000000x
xp000000000000x
xs000000000000x
x0000b000b0000x
x0000b000b0000x
x0000b000b0000x
x0000000000000x
x0000000000000x
xxxxxxxxxxxxxxx
