zxxxxxxxxxxxxxz
zx00000000000xz
zx00000000000xz
zx000b000b000xz
zx000b000b000xz
xx000b000b000xx
ss00000000000ng
ps00000000000ng
ss00000000000ng
xx000b000b000xx
zx000b000b000xz
zx000b000b000xz
zx00000000000xz
zx00000000000xz
zxxxxxxxxxxxxxz
