xxxxxxxxxxxxxxx
x0000000000000x
x0000000000000x
x00bb00000bb00x
x00bb00000bb00x
x0000000000000x
x0000000000000x
x0000000000000x
x0000000000000x
x0000000000000x
x00bb00000bb00x
x00bb00000bb00x
x0000000000000x
x00000sps00000x
xxxxxxxxxxxxxxx
