ssxxxxxxxxxxxxx
ss00000000000xx
xx00000000000xx
xx00xxxxxxx00xx
xx00000000000xx
xx00xx000xx00xx
xx00xx000xx00xx
xx00xx000xx00xx
xx00000000000xx
xx00000000000xx
xx00xxx00xxx0xx
xx00xxx00xxx0xx
xx00000000000xx
xx00000000000gg
xxxxxxxxxxxxxgg
