psxxxxxxxxxxxxz
ss00000000000xz
xx00000000000xz
zx00xxxxxxx00xz
zx00000000000xz
zx00xx000xx00xz
zx00xx000xx00xz
zx00xx000xx00xz
zx00000000000xz
zx00000000000xz
zx00xxx00xxx0xz
zx00xxx00xxx0xz
zx00000000000xz
zx00000000000gg
zzxxxxxxxxxxxgg
